16 16

.......##...#...
.......##...#...
####...##.#####.
.......##.......
..#######.......
.......###.##...
.###.#.##....##.
...#.#.##.##..#.
.#...#.##.#.....
###.##.##.#####
.......##....#..
..#.#..##....#..
....#..#######..
..###..##.......
..###..##...##.#
.......##.......
